#########
###B    #
#     ###
# ###  C#
#     # #
#  ## # #
## #  # #
## # ## #
# A    D#
#########